11111111111111111
10P0110000000C0E1
11000C0001110C001
1111111000010C011
10000111110010001
1C000010C10010C01
10001000C000100C1
10000100000110011
1C000111C1010C001
1C000C00000000E01
11111111111111111