11111111111111111
1001110000PC00001
1100CC00C11100001
1111101CC00000011
10001111010110011
100000C0C01000011
10000011100000E01
11111111111111111