11111111
1PEECC01
10000001
10000001
11111111