11111111111111111
10011100C000000E1
11111111111111111