11111111111111111
10011100C0P0000E1

11111111111111111