11111111111111111
10P11100C000000E1
11111111111111101